0 0 0 0 0 0 0 0 0 0 0 0 0 0 0 3 0 0 3 0 0 3 0 0 3 0 0 3 0 0 3 0 0 3 0 0 3 0 0 3 0 0 3 0 0 3 0 0 6 0 0 3 0 0 6 0 0 3 0 0 3 0 0 3 0 0 3 0 0 3 0 0 3 0 0 3 0 0 3 0 0 3 0 0 3 0 0 3 0 0 3 0 0 3 0 0 3 0 0 3 0 0 3 0 0 6 0 0 6 0 0 3 0 0 6 0 0 3 0 0 3 0 0 3 0 0 3 0 0 3 0 0 3 0 0 3 0 0 3 0 0 3 0 0 3 0 0 3 0 0 3 0 0 3 0 0 6 0 0 3 0 0 3 0 0 3 0 0 3 0 0 3 0 0 3 0 0 3 0 0 3 0 0 3 0 0 3 0 0 3 0 0 3 0 0 3 0 0 3 0 0 3 0 0 3 0 0 3 0 0 3 0 0 6 0 0 3 0 0 6 0 0 3 0 0 3 0 0 3 0 0 3 0 0 3 0 0 3 0 0 3 0 0 3 0 0 3 0 0 3 0 0 3 0 0 3 0 0 3 0 0 3 0 0 6 0 0 3 0 0 3 0 0 3 0 0 3 0 0 3 0 0 3 0 0 3 0 0 3 0 0 3 0 0 3 0 0 3 0 0 3 0 0 3 0 0 3 0 0 3 0 0 3 0 0 3 0 0 3 0 0 6 0 0 3 0 0 6 0 0 3 0 0 3 0 0 3 0 0 3 0 0 3 0 0 3 0 0 3 0 0 3 0 0 3 0 0 3 0 0 3 0 0 3 0 0 3 0 0 3 0 0 6 0 0 3 0 0 3 0 0 3 0 0 3 0 0 3 0 0 3 0 0 3 0 0 3 0 0 3 0 0 3 0 0 3 0 0 3 0 0 3 0 0 3 0 0 3 0 0 3 0 0 3 0 0 3 0 0 3 0 0 3 0 0 6 0 0 3 0 0 6 0 0 3 0 0 3 0 0 3 0 0 3 0 0 3 0 0 3 0 0 3 0 0 3 0 0 3 0 0 3 0 0 3 0 0 3 0 0 3 0 0 3 0 0 3 0 0 3 0 0 6 0 0 6 0 0 3 0 0 6 0 0 3 0 0 3 0 0 3 0 0 3 0 0 3 0 0 3 0 0 3 0 0 3 0 0 3 0 0 3 0 0 3 0 0 3 0 0 3 0 0 6 0 0 3 0 0 3 0 0 3 0 0 3 0 0 3 0 0 3 0 0 3 0 0 3 0 0 3 0 0 3 0 0 3 0 0 3 0 0 3 0 0 3 0 0 3 0 0 3 0 0 3 0 0 3 0 0 6 0 0 3 0 0 6 0 0 3 0 0 3 0 0 3 0 0 3 0 0 3 0 0 3 0 0 3 0 0 3 0 0 3 0 0 3 0 0 3 0 0 3 0 0 3 0 0 3 0 0 6 0 0 3 0 0 3 0 0 3 0 0 3 0 0 3 0 0 3 0 0 3 0 0 3 0 0 3 0 0 3 0 0 3 0 0 3 0 0 3 0 0 3 0 0 3 0 0 3 0 0 3 0 0 3 0 0 6 0 0 3 0 0 6 0 0 3 0 0 3 0 0 3 0 0 3 0 0 3 0 0 3 0 0 3 0 0 3 0 0 3 0 0 3 0 0 3 0 0
0 0 0 0 0 0 0 0 0 0 0 0 0 0 0 3 0 0 6 0 0 3 0 0 3 0 0 6 0 0 3 0 0 3 0 0 3 0 0 3 0 0 3 0 0 6 0 0 1 0 0 6 0 0 1 0 0 3 0 0 6 0 0 6 0 0 3 0 0 3 0 0 3 0 0 3 0 0 3 0 0 3 0 0 3 0 0 6 0 0 3 0 0 3 0 0 3 0 0 3 0 0 6 0 0 1 0 0 1 0 0 6 0 0 1 0 0 3 0 0 6 0 0 3 0 0 3 0 0 3 0 0 3 0 0 3 0 0 3 0 0 3 0 0 3 0 0 3 0 0 3 0 0 6 0 0 1 0 0 6 0 0 6 0 0 3 0 0 6 0 0 3 0 0 3 0 0 3 0 0 3 0 0 3 0 0 3 0 0 3 0 0 3 0 0 3 0 0 3 0 0 3 0 0 3 0 0 3 0 0 6 0 0 1 0 0 6 0 0 1 0 0 6 0 0 3 0 0 6 0 0 3 0 0 3 0 0 3 0 0 3 0 0 3 0 0 3 0 0 3 0 0 3 0 0 3 0 0 3 0 0 6 0 0 1 0 0 6 0 0 6 0 0 3 0 0 6 0 0 3 0 0 3 0 0 3 0 0 3 0 0 3 0 0 3 0 0 3 0 0 3 0 0 3 0 0 3 0 0 3 0 0 3 0 0 3 0 0 6 0 0 1 0 0 6 0 0 1 0 0 6 0 0 3 0 0 6 0 0 3 0 0 3 0 0 3 0 0 3 0 0 3 0 0 3 0 0 3 0 0 3 0 0 3 0 0 3 0 0 6 0 0 1 0 0 6 0 0 6 0 0 3 0 0 6 0 0 3 0 0 3 0 0 3 0 0 3 0 0 3 0 0 3 0 0 6 0 0 3 0 0 3 0 0 6 0 0 3 0 0 3 0 0 3 0 0 3 0 0 3 0 0 6 0 0 1 0 0 6 0 0 1 0 0 3 0 0 6 0 0 6 0 0 3 0 0 3 0 0 3 0 0 3 0 0 3 0 0 3 0 0 3 0 0 6 0 0 3 0 0 3 0 0 3 0 0 3 0 0 6 0 0 1 0 0 1 0 0 6 0 0 1 0 0 3 0 0 6 0 0 3 0 0 3 0 0 3 0 0 3 0 0 3 0 0 3 0 0 3 0 0 3 0 0 3 0 0 3 0 0 6 0 0 1 0 0 6 0 0 6 0 0 3 0 0 6 0 0 3 0 0 3 0 0 3 0 0 3 0 0 3 0 0 3 0 0 3 0 0 3 0 0 3 0 0 3 0 0 3 0 0 3 0 0 3 0 0 6 0 0 1 0 0 6 0 0 1 0 0 6 0 0 3 0 0 6 0 0 3 0 0 3 0 0 3 0 0 3 0 0 3 0 0 3 0 0 3 0 0 3 0 0 3 0 0 3 0 0 6 0 0 1 0 0 6 0 0 6 0 0 3 0 0 6 0 0 3 0 0 3 0 0 3 0 0 3 0 0 3 0 0 3 0 0 3 0 0 3 0 0 3 0 0 3 0 0 3 0 0 3 0 0 3 0 0 6 0 0 1 0 0 6 0 0 1 0 0 6 0 0 3 0 0 6 0 0 3 0 0 3 0 0 3 0 0 3 0 0 3 0 0 3 0 0 3 0 0 3 0 0
0 0 0 0 0 0 0 0 0 0 0 0 0 0 0 6 0 0 1 0 0 3 0 0 6 0 0 1 0 0 6 0 0 3 0 0 3 0 0 3 0 0 6 0 0 1 0 0 1 0 0 1 0 0 1 0 0 6 0 0 1 0 0 1 0 0 3 0 0 6 0 0 3 0 0 3 0 0 6 0 0 6 0 0 3 0 0 1 0 0 6 0 0 3 0 0 3 0 0 6 0 0 1 0 0 1 0 0 1 0 0 1 0 0 1 0 0 6 0 0 1 0 0 3 0 0 6 0 0 3 0 0 6 0 0 6 0 0 3 0 0 3 0 0 3 0 0 3 0 0 6 0 0 1 0 0 1 0 0 1 0 0 1 0 0 6 0 0 1 0 0 6 0 0 3 0 0 3 0 0 3 0 0 3 0 0 6 0 0 3 0 0 3 0 0 6 0 0 3 0 0 3 0 0 3 0 0 6 0 0 1 0 0 1 0 0 1 0 0 1 0 0 1 0 0 6 0 0 1 0 0 3 0 0 6 0 0 3 0 0 6 0 0 6 0 0 3 0 0 3 0 0 3 0 0 3 0 0 6 0 0 1 0 0 1 0 0 1 0 0 1 0 0 6 0 0 1 0 0 6 0 0 3 0 0 3 0 0 3 0 0 3 0 0 6 0 0 3 0 0 3 0 0 6 0 0 3 0 0 3 0 0 3 0 0 6 0 0 1 0 0 1 0 0 1 0 0 1 0 0 1 0 0 6 0 0 1 0 0 3 0 0 6 0 0 3 0 0 6 0 0 6 0 0 3 0 0 3 0 0 3 0 0 3 0 0 6 0 0 1 0 0 1 0 0 1 0 0 1 0 0 6 0 0 1 0 0 6 0 0 3 0 0 3 0 0 3 0 0 3 0 0 6 0 0 1 0 0 3 0 0 6 0 0 1 0 0 6 0 0 3 0 0 3 0 0 3 0 0 6 0 0 1 0 0 1 0 0 1 0 0 1 0 0 6 0 0 1 0 0 1 0 0 3 0 0 6 0 0 3 0 0 3 0 0 6 0 0 6 0 0 3 0 0 1 0 0 6 0 0 3 0 0 3 0 0 6 0 0 1 0 0 1 0 0 1 0 0 1 0 0 1 0 0 6 0 0 1 0 0 3 0 0 6 0 0 3 0 0 6 0 0 6 0 0 3 0 0 3 0 0 3 0 0 3 0 0 6 0 0 1 0 0 1 0 0 1 0 0 1 0 0 6 0 0 1 0 0 6 0 0 3 0 0 3 0 0 3 0 0 3 0 0 6 0 0 3 0 0 3 0 0 6 0 0 3 0 0 3 0 0 3 0 0 6 0 0 1 0 0 1 0 0 1 0 0 1 0 0 1 0 0 6 0 0 1 0 0 3 0 0 6 0 0 3 0 0 6 0 0 6 0 0 3 0 0 3 0 0 3 0 0 3 0 0 6 0 0 1 0 0 1 0 0 1 0 0 1 0 0 6 0 0 1 0 0 6 0 0 3 0 0 3 0 0 3 0 0 3 0 0 6 0 0 3 0 0 3 0 0 6 0 0 3 0 0 3 0 0 3 0 0 6 0 0 1 0 0 1 0 0 1 0 0 1 0 0 1 0 0 6 0 0 1 0 0 3 0 0 6 0 0 3 0 0 6 0 0 6 0 0 3 0 0 3 0 0 3 0 0
0 0 0 0 0 0 0 0 0 0 0 0 0 0 0 1 0 0 1 0 0 6 0 0 1 0 0 1 0 0 1 0 0 6 0 0 3 0 0 6 0 0 1 0 0 1 0 0 1 0 0 1 0 0 1 0 0 1 0 0 1 0 0 1 0 0 6 0 0 1 0 0 6 0 0 6 0 0 1 0 0 1 0 0 6 0 0 1 0 0 1 0 0 6 0 0 6 0 0 1 0 0 1 0 0 1 0 0 1 0 0 1 0 0 1 0 0 1 0 0 1 0 0 6 0 0 1 0 0 3 0 0 1 0 0 1 0 0 6 0 0 3 0 0 3 0 0 6 0 0 1 0 0 1 0 0 9 0 0 1 0 0 1 0 0 1 0 0 1 0 0 1 0 0 6 0 0 6 0 0 3 0 0 6 0 0 1 0 0 6 0 0 6 0 0 1 0 0 6 0 0 3 0 0 6 0 0 1 0 0 1 0 0 9 0 0 1 0 0 9 0 0 1 0 0 1 0 0 1 0 0 6 0 0 1 0 0 3 0 0 1 0 0 1 0 0 6 0 0 3 0 0 3 0 0 6 0 0 1 0 0 1 0 0 9 0 0 1 0 0 1 0 0 1 0 0 1 0 0 1 0 0 6 0 0 6 0 0 3 0 0 6 0 0 1 0 0 6 0 0 6 0 0 1 0 0 6 0 0 3 0 0 6 0 0 1 0 0 1 0 0 9 0 0 1 0 0 9 0 0 1 0 0 1 0 0 1 0 0 6 0 0 1 0 0 3 0 0 1 0 0 1 0 0 6 0 0 3 0 0 3 0 0 6 0 0 1 0 0 1 0 0 9 0 0 1 0 0 1 0 0 1 0 0 1 0 0 1 0 0 6 0 0 6 0 0 3 0 0 6 0 0 1 0 0 1 0 0 6 0 0 1 0 0 1 0 0 1 0 0 6 0 0 3 0 0 6 0 0 1 0 0 1 0 0 1 0 0 1 0 0 1 0 0 1 0 0 1 0 0 1 0 0 6 0 0 1 0 0 6 0 0 6 0 0 1 0 0 1 0 0 6 0 0 1 0 0 1 0 0 6 0 0 6 0 0 1 0 0 1 0 0 1 0 0 1 0 0 1 0 0 1 0 0 1 0 0 1 0 0 6 0 0 1 0 0 3 0 0 1 0 0 1 0 0 6 0 0 3 0 0 3 0 0 6 0 0 1 0 0 1 0 0 9 0 0 1 0 0 1 0 0 1 0 0 1 0 0 1 0 0 6 0 0 6 0 0 3 0 0 6 0 0 1 0 0 6 0 0 6 0 0 1 0 0 6 0 0 3 0 0 6 0 0 1 0 0 1 0 0 9 0 0 1 0 0 9 0 0 1 0 0 1 0 0 1 0 0 6 0 0 1 0 0 3 0 0 1 0 0 1 0 0 6 0 0 3 0 0 3 0 0 6 0 0 1 0 0 1 0 0 9 0 0 1 0 0 1 0 0 1 0 0 1 0 0 1 0 0 6 0 0 6 0 0 3 0 0 6 0 0 1 0 0 6 0 0 6 0 0 1 0 0 6 0 0 3 0 0 6 0 0 1 0 0 1 0 0 9 0 0 1 0 0 9 0 0 1 0 0 1 0 0 1 0 0 6 0 0 1 0 0 3 0 0 1 0 0 1 0 0 6 0 0 3 0 0 3 0 0
0 0 0 0 0 0 0 0 0 0 0 0 0 0 0 1 0 0 1 0 0 1 0 0 1 0 0 1 0 0 1 0 0 1 0 0 6 0 0 1 0 0 1 0 0 1 0 0 9 0 0 1 0 0 9 0 0 1 0 0 1 0 0 1 0 0 1 0 0 1 0 0 1 0 0 1 0 0 1 0 0 1 0 0 1 0 0 1 0 0 1 0 0 1 0 0 1 0 0 1 0 0 1 0 0 9 0 0 9 0 0 1 0 0 9 0 0 1 0 0 1 0 0 1 0 0 1 0 0 6 0 0 1 0 0 1 0 0 1 0 0 6 0 0 6 0 0 1 0 0 1 0 0 9 0 0 3 0 0 9 0 0 9 0 0 1 0 0 9 0 0 1 0 0 1 0 0 1 0 0 6 0 0 1 0 0 1 0 0 1 0 0 1 0 0 1 0 0 1 0 0 6 0 0 1 0 0 1 0 0 9 0 0 3 0 0 9 0 0 1 0 0 9 0 0 1 0 0 9 0 0 1 0 0 1 0 0 6 0 0 1 0 0 1 0 0 1 0 0 6 0 0 6 0 0 1 0 0 1 0 0 9 0 0 3 0 0 9 0 0 9 0 0 1 0 0 9 0 0 1 0 0 1 0 0 1 0 0 6 0 0 1 0 0 1 0 0 1 0 0 1 0 0 1 0 0 1 0 0 6 0 0 1 0 0 1 0 0 9 0 0 3 0 0 9 0 0 1 0 0 9 0 0 1 0 0 9 0 0 1 0 0 1 0 0 6 0 0 1 0 0 1 0 0 1 0 0 6 0 0 6 0 0 1 0 0 1 0 0 9 0 0 3 0 0 9 0 0 9 0 0 1 0 0 9 0 0 1 0 0 1 0 0 1 0 0 6 0 0 1 0 0 1 0 0 1 0 0 1 0 0 1 0 0 1 0 0 1 0 0 1 0 0 6 0 0 1 0 0 1 0 0 1 0 0 9 0 0 1 0 0 9 0 0 1 0 0 1 0 0 1 0 0 1 0 0 1 0 0 1 0 0 1 0 0 1 0 0 1 0 0 1 0 0 1 0 0 1 0 0 1 0 0 1 0 0 1 0 0 1 0 0 9 0 0 9 0 0 1 0 0 9 0 0 1 0 0 1 0 0 1 0 0 1 0 0 6 0 0 1 0 0 1 0 0 1 0 0 6 0 0 6 0 0 1 0 0 1 0 0 9 0 0 3 0 0 9 0 0 9 0 0 1 0 0 9 0 0 1 0 0 1 0 0 1 0 0 6 0 0 1 0 0 1 0 0 1 0 0 1 0 0 1 0 0 1 0 0 6 0 0 1 0 0 1 0 0 9 0 0 3 0 0 9 0 0 1 0 0 9 0 0 1 0 0 9 0 0 1 0 0 1 0 0 6 0 0 1 0 0 1 0 0 1 0 0 6 0 0 6 0 0 1 0 0 1 0 0 9 0 0 3 0 0 9 0 0 9 0 0 1 0 0 9 0 0 1 0 0 1 0 0 1 0 0 6 0 0 1 0 0 1 0 0 1 0 0 1 0 0 1 0 0 1 0 0 6 0 0 1 0 0 1 0 0 9 0 0 3 0 0 9 0 0 1 0 0 9 0 0 1 0 0 9 0 0 1 0 0 1 0 0 6 0 0 1 0 0 1 0 0 1 0 0 6 0 0 6 0 0
0 0 0 0 0 0 0 0 0 0 0 0 0 0 0 1 0 0 9 0 0 1 0 0 1 0 0 9 0 0 1 0 0 1 0 0 1 0 0 1 0 0 1 0 0 9 0 0 3 0 0 9 0 0 3 0 0 1 0 0 9 0 0 9 0 0 1 0 0 1 0 0 1 0 0 1 0 0 1 0 0 1 0 0 1 0 0 9 0 0 1 0 0 1 0 0 1 0 0 1 0 0 9 0 0 3 0 0 3 0 0 9 0 0 3 0 0 1 0 0 9 0 0 1 0 0 9 0 0 1 0 0 9 0 0 9 0 0 1 0 0 1 0 0 1 0 0 1 0 0 9 0 0 3 0 0 3 0 0 3 0 0 3 0 0 9 0 0 3 0 0 9 0 0 1 0 0 1 0 0 1 0 0 1 0 0 9 0 0 1 0 0 1 0 0 9 0 0 1 0 0 1 0 0 1 0 0 9 0 0 3 0 0 3 0 0 3 0 0 3 0 0 3 0 0 9 0 0 3 0 0 1 0 0 9 0 0 1 0 0 9 0 0 9 0 0 1 0 0 1 0 0 1 0 0 1 0 0 9 0 0 3 0 0 3 0 0 3 0 0 3 0 0 9 0 0 3 0 0 9 0 0 1 0 0 1 0 0 1 0 0 1 0 0 9 0 0 1 0 0 1 0 0 9 0 0 1 0 0 1 0 0 1 0 0 9 0 0 3 0 0 3 0 0 3 0 0 3 0 0 3 0 0 9 0 0 3 0 0 1 0 0 9 0 0 1 0 0 9 0 0 9 0 0 1 0 0 1 0 0 1 0 0 1 0 0 9 0 0 3 0 0 3 0 0 3 0 0 3 0 0 9 0 0 3 0 0 9 0 0 1 0 0 1 0 0 1 0 0 1 0 0 1 0 0 9 0 0 1 0 0 1 0 0 9 0 0 1 0 0 1 0 0 1 0 0 1 0 0 1 0 0 9 0 0 3 0 0 9 0 0 3 0 0 1 0 0 9 0 0 9 0 0 1 0 0 1 0 0 1 0 0 1 0 0 1 0 0 1 0 0 1 0 0 9 0 0 1 0 0 1 0 0 1 0 0 1 0 0 9 0 0 3 0 0 3 0 0 9 0 0 3 0 0 1 0 0 9 0 0 1 0 0 9 0 0 1 0 0 9 0 0 9 0 0 1 0 0 1 0 0 1 0 0 1 0 0 9 0 0 3 0 0 3 0 0 3 0 0 3 0 0 9 0 0 3 0 0 9 0 0 1 0 0 1 0 0 1 0 0 1 0 0 9 0 0 1 0 0 1 0 0 9 0 0 1 0 0 1 0 0 1 0 0 9 0 0 3 0 0 3 0 0 3 0 0 3 0 0 3 0 0 9 0 0 3 0 0 1 0 0 9 0 0 1 0 0 9 0 0 9 0 0 1 0 0 1 0 0 1 0 0 1 0 0 9 0 0 3 0 0 3 0 0 3 0 0 3 0 0 9 0 0 3 0 0 9 0 0 1 0 0 1 0 0 1 0 0 1 0 0 9 0 0 1 0 0 1 0 0 9 0 0 1 0 0 1 0 0 1 0 0 9 0 0 3 0 0 3 0 0 3 0 0 3 0 0 3 0 0 9 0 0 3 0 0 1 0 0 9 0 0 1 0 0 9 0 0 9 0 0 1 0 0 1 0 0 1 0 0
0 0 0 0 0 0 0 0 0 0 0 0 0 0 0 9 0 0 3 0 0 1 0 0 9 0 0 3 0 0 9 0 0 1 0 0 1 0 0 1 0 0 9 0 0 3 0 0 3 0 0 3 0 0 3 0 0 9 0 0 3 0 0 3 0 0 1 0 0 9 0 0 1 0 0 1 0 0 9 0 0 9 0 0 1 0 0 3 0 0 9 0 0 1 0 0 1 0 0 9 0 0 3 0 0 3 0 0 3 0 0 3 0 0 3 0 0 9 0 0 3 0 0 9 0 0 3 0 0 1 0 0 3 0 0 3 0 0 9 0 0 1 0 0 1 0 0 9 0 0 3 0 0 3 0 0 3 0 0 3 0 0 3 0 0 3 0 0 3 0 0 3 0 0 9 0 0 9 0 0 1 0 0 9 0 0 3 0 0 9 0 0 9 0 0 3 0 0 9 0 0 1 0 0 9 0 0 3 0 0 3 0 0 3 0 0 3 0 0 3 0 0 3 0 0 3 0 0 3 0 0 9 0 0 3 0 0 1 0 0 3 0 0 3 0 0 9 0 0 1 0 0 1 0 0 9 0 0 3 0 0 3 0 0 3 0 0 3 0 0 3 0 0 3 0 0 3 0 0 3 0 0 9 0 0 9 0 0 1 0 0 9 0 0 3 0 0 9 0 0 9 0 0 3 0 0 9 0 0 1 0 0 9 0 0 3 0 0 3 0 0 3 0 0 3 0 0 3 0 0 3 0 0 3 0 0 3 0 0 9 0 0 3 0 0 1 0 0 3 0 0 3 0 0 9 0 0 1 0 0 1 0 0 9 0 0 3 0 0 3 0 0 3 0 0 3 0 0 3 0 0 3 0 0 3 0 0 3 0 0 9 0 0 9 0 0 1 0 0 9 0 0 9 0 0 3 0 0 1 0 0 9 0 0 3 0 0 9 0 0 1 0 0 1 0 0 1 0 0 9 0 0 3 0 0 3 0 0 3 0 0 3 0 0 9 0 0 3 0 0 3 0 0 1 0 0 9 0 0 1 0 0 1 0 0 9 0 0 9 0 0 1 0 0 3 0 0 9 0 0 1 0 0 1 0 0 9 0 0 3 0 0 3 0 0 3 0 0 3 0 0 3 0 0 9 0 0 3 0 0 9 0 0 3 0 0 1 0 0 3 0 0 3 0 0 9 0 0 1 0 0 1 0 0 9 0 0 3 0 0 3 0 0 3 0 0 3 0 0 3 0 0 3 0 0 3 0 0 3 0 0 9 0 0 9 0 0 1 0 0 9 0 0 3 0 0 9 0 0 9 0 0 3 0 0 9 0 0 1 0 0 9 0 0 3 0 0 3 0 0 3 0 0 3 0 0 3 0 0 3 0 0 3 0 0 3 0 0 9 0 0 3 0 0 1 0 0 3 0 0 3 0 0 9 0 0 1 0 0 1 0 0 9 0 0 3 0 0 3 0 0 3 0 0 3 0 0 3 0 0 3 0 0 3 0 0 3 0 0 9 0 0 9 0 0 1 0 0 9 0 0 3 0 0 9 0 0 9 0 0 3 0 0 9 0 0 1 0 0 9 0 0 3 0 0 3 0 0 3 0 0 3 0 0 3 0 0 3 0 0 3 0 0 3 0 0 9 0 0 3 0 0 1 0 0 3 0 0 3 0 0 9 0 0 1 0 0 1 0 0
0 0 0 0 0 0 0 0 0 0 0 0 0 0 0 3 0 0 3 0 0 9 0 0 3 0 0 3 0 0 3 0 0 9 0 0 1 0 0 9 0 0 3 0 0 3 0 0 3 0 0 3 0 0 3 0 0 3 0 0 3 0 0 3 0 0 9 0 0 3 0 0 9 0 0 9 0 0 3 0 0 3 0 0 9 0 0 3 0 0 3 0 0 9 0 0 9 0 0 3 0 0 3 0 0 3 0 0 3 0 0 3 0 0 3 0 0 3 0 0 3 0 0 3 0 0 3 0 0 9 0 0 3 0 0 3 0 0 3 0 0 9 0 0 9 0 0 3 0 0 3 0 0 3 0 0 3 0 0 3 0 0 3 0 0 3 0 0 3 0 0 3 0 0 3 0 0 3 0 0 9 0 0 3 0 0 3 0 0 3 0 0 3 0 0 3 0 0 3 0 0 9 0 0 3 0 0 3 0 0 3 0 0 3 0 0 3 0 0 3 0 0 3 0 0 3 0 0 3 0 0 3 0 0 3 0 0 9 0 0 3 0 0 3 0 0 3 0 0 9 0 0 9 0 0 3 0 0 3 0 0 3 0 0 3 0 0 3 0 0 3 0 0 3 0 0 3 0 0 3 0 0 3 0 0 3 0 0 9 0 0 3 0 0 3 0 0 3 0 0 3 0 0 3 0 0 3 0 0 9 0 0 3 0 0 3 0 0 3 0 0 3 0 0 3 0 0 3 0 0 3 0 0 3 0 0 3 0 0 3 0 0 3 0 0 9 0 0 3 0 0 3 0 0 3 0 0 9 0 0 9 0 0 3 0 0 3 0 0 3 0 0 3 0 0 3 0 0 3 0 0 3 0 0 3 0 0 3 0 0 3 0 0 3 0 0 9 0 0 3 0 0 3 0 0 3 0 0 9 0 0 3 0 0 3 0 0 3 0 0 9 0 0 1 0 0 9 0 0 3 0 0 3 0 0 3 0 0 3 0 0 3 0 0 3 0 0 3 0 0 3 0 0 9 0 0 3 0 0 9 0 0 9 0 0 3 0 0 3 0 0 9 0 0 3 0 0 3 0 0 9 0 0 9 0 0 3 0 0 3 0 0 3 0 0 3 0 0 3 0 0 3 0 0 3 0 0 3 0 0 3 0 0 3 0 0 9 0 0 3 0 0 3 0 0 3 0 0 9 0 0 9 0 0 3 0 0 3 0 0 3 0 0 3 0 0 3 0 0 3 0 0 3 0 0 3 0 0 3 0 0 3 0 0 3 0 0 9 0 0 3 0 0 3 0 0 3 0 0 3 0 0 3 0 0 3 0 0 9 0 0 3 0 0 3 0 0 3 0 0 3 0 0 3 0 0 3 0 0 3 0 0 3 0 0 3 0 0 3 0 0 3 0 0 9 0 0 3 0 0 3 0 0 3 0 0 9 0 0 9 0 0 3 0 0 3 0 0 3 0 0 3 0 0 3 0 0 3 0 0 3 0 0 3 0 0 3 0 0 3 0 0 3 0 0 9 0 0 3 0 0 3 0 0 3 0 0 3 0 0 3 0 0 3 0 0 9 0 0 3 0 0 3 0 0 3 0 0 3 0 0 3 0 0 3 0 0 3 0 0 3 0 0 3 0 0 3 0 0 3 0 0 9 0 0 3 0 0 3 0 0 3 0 0 9 0 0 9 0 0
0 0 0 0 0 0 0 0 0 0 0 0 0 0 0 3 0 0 3 0 0 3 0 0 3 0 0 3 0 0 3 0 0 3 0 0 9 0 0 3 0 0 3 0 0 3 0 0 3 0 0 3 0 0 3 0 0 3 0 0 3 0 0 3 0 0 3 0 0 3 0 0 3 0 0 3 0 0 3 0 0 3 0 0 3 0 0 3 0 0 3 0 0 3 0 0 3 0 0 3 0 0 3 0 0 3 0 0 3 0 0 3 0 0 3 0 0 3 0 0 3 0 0 3 0 0 3 0 0 3 0 0 3 0 0 3 0 0 3 0 0 3 0 0 3 0 0 3 0 0 3 0 0 3 0 0 3 0 0 3 0 0 3 0 0 3 0 0 3 0 0 3 0 0 3 0 0 3 0 0 3 0 0 3 0 0 3 0 0 3 0 0 3 0 0 3 0 0 3 0 0 3 0 0 3 0 0 3 0 0 3 0 0 3 0 0 3 0 0 3 0 0 3 0 0 3 0 0 3 0 0 3 0 0 3 0 0 3 0 0 3 0 0 3 0 0 3 0 0 3 0 0 3 0 0 3 0 0 3 0 0 3 0 0 3 0 0 3 0 0 3 0 0 3 0 0 3 0 0 3 0 0 3 0 0 3 0 0 3 0 0 3 0 0 3 0 0 3 0 0 3 0 0 3 0 0 3 0 0 3 0 0 3 0 0 3 0 0 3 0 0 3 0 0 3 0 0 3 0 0 3 0 0 3 0 0 3 0 0 3 0 0 3 0 0 3 0 0 3 0 0 3 0 0 3 0 0 3 0 0 3 0 0 3 0 0 3 0 0 3 0 0 3 0 0 3 0 0 3 0 0 3 0 0 3 0 0 3 0 0 3 0 0 3 0 0 3 0 0 3 0 0 3 0 0 3 0 0 3 0 0 3 0 0 3 0 0 3 0 0 3 0 0 9 0 0 3 0 0 3 0 0 3 0 0 3 0 0 3 0 0 3 0 0 3 0 0 3 0 0 3 0 0 3 0 0 3 0 0 3 0 0 3 0 0 3 0 0 3 0 0 3 0 0 3 0 0 3 0 0 3 0 0 3 0 0 3 0 0 3 0 0 3 0 0 3 0 0 3 0 0 3 0 0 3 0 0 3 0 0 3 0 0 3 0 0 3 0 0 3 0 0 3 0 0 3 0 0 3 0 0 3 0 0 3 0 0 3 0 0 3 0 0 3 0 0 3 0 0 3 0 0 3 0 0 3 0 0 3 0 0 3 0 0 3 0 0 3 0 0 3 0 0 3 0 0 3 0 0 3 0 0 3 0 0 3 0 0 3 0 0 3 0 0 3 0 0 3 0 0 3 0 0 3 0 0 3 0 0 3 0 0 3 0 0 3 0 0 3 0 0 3 0 0 3 0 0 3 0 0 3 0 0 3 0 0 3 0 0 3 0 0 3 0 0 3 0 0 3 0 0 3 0 0 3 0 0 3 0 0 3 0 0 3 0 0 3 0 0 3 0 0 3 0 0 3 0 0 3 0 0 3 0 0 3 0 0 3 0 0 3 0 0 3 0 0 3 0 0 3 0 0 3 0 0 3 0 0 3 0 0 3 0 0 3 0 0 3 0 0 3 0 0 3 0 0 3 0 0 3 0 0 3 0 0 3 0 0 3 0 0 3 0 0 3 0 0 3 0 0
2 2 2 2 2 2 2 2 2 2 2 2 2 2 2 2 2 2 2 2 2 2 2 2 2 2 2 2 2 2 2 2 2 2 2 2 2 2 2 2 2 2 2 2 2 2 2 2 2 2 2 2 2 2 2 2 2 2 2 2 2 2 2 2 2 2 2 2 2 2 2 2 2 2 2 2 2 2 2 2 2 2 2 2 2 2 2 2 2 2 2 2 2 2 2 2 2 2 2 2 2 2 2 2 2 2 2 2 2 2 2 2 2 2 2 2 2 2 2 2 2 2 2 2 2 2 2 2 2 2 2 2 2 2 2 2 2 2 2 2 2 2 2 2 2 2 2 2 2 2 2 2 2 2 2 2 2 2 2 2 2 2 2 2 2 2 2 2 2 2 2 2 2 2 2 2 2 2 2 2 2 2 2 2 2 2 2 2 2 2 2 2 2 2 2 2 2 2 2 2 2 2 2 2 2 2 2 2 2 2 2 2 2 2 2 2 2 2 2 2 2 2 2 2 2 2 2 2 2 2 2 2 2 2 2 2 2 2 2 2 2 2 2 2 2 2 2 2 2 2 2 2 2 2 2 2 2 2 2 2 2 2 2 2 2 2 2 2 2 2 2 2 2 2 2 2 2 2 2 2 2 2 2 2 2 2 2 2 2 2 2 2 2 2 2 2 2 2 2 2 2 2 2 2 2 2 2 2 2 2 2 2 2 2 2 2 2 2 2 2 2 2 2 2 2 2 2 2 2 2 2 2 2 2 2 2 2 2 2 2 2 2 2 2 2 2 2 2 2 2 2 2 2 2 2 2 2 2 2 2 2 2 2 2 2 2 2 2 2 2 2 2 2 2 2 2 2 2 2 2 2 2 2 2 2 2 2 2 2 2 2 2 2 2 2 2 2 2 2 2 2 2 2 2 2 2 2 2 2 2 2 2 2 2 2 2 2 2 2 2 2 2 2 2 2 2 2 2 2 2 2 2 2 2 2 2 2 2 2 2 2 2 2 2 2 2 2 2 2 2 2 2 2 2 2 2 2 2 2 2 2 2 2 2 2 2 2 2 2 2 2 2 2 2 2 2 2 2 2 2 2 2 2 2 2 2 2 2 2 2 2 2 2 2 2 2 2 2 2 2 2 2 2 2 2 2 2 2 2 2 2 2 2 2 2 2 2 2 2 2 2 2 2 2 2 2 2 2 2 2 2 2 2 2 2 2 2 2 2 2 2 2 2 2 2 2 2 2 2 2 2 2 2 2 2 2 2 2 2 2 2 2 2 2 2 2 2 2 2 2 2 2 2 2 2 2 2 2 2 2 2 2 2 2 2 2 2 2 2 2 2 2 2 2 2 2 2 2 2 2 2 2 2 2 2 2 2 2 2 2 2 2 2 2 2 2 2 2 2 2 2 2 2 2 2 2 2 2 2 2 2 2 2 2 2 2 2 2 2 2 2 2 2 2 2 2 2 2 2 2 2 2 2 2 2 2 2 2 2 2 2 2 2 2 2 2 2 2 2 2 2 2 2 2 2 2 2 2 2 2 2 2 2 2 2 2 2 2 2 2 2 2 2 2 2 2 2 2 2 2 2 2 2 2 2 2 2 2 2 2 2 2 2 2 2 2 2 2 2 2 2 2 2 2 2 2 2 2 2 2 2 2 2 2 2 2 2 2 2 2 2 2 2 2 2 2 2 2 2 2